
NO ./texture/4k_forest.xpm
SO ./texture/4k_forest.xpm
WE ./texture/4k_forest.xpm
EA ./texture/4k_forest.xpm
F 33,84,24
C 28,28,28

111111111111111111          
1001 1001      101
100010001     1001
100000001111110001
100000000000000001
100000000000000001
1000N0000000000001
100000000000000001
100000000000000001
1000000001111000001
1000000011  1100011
100000111    100011
1000111      10011
10111       111111
111
 