


NO ./texture/h1.xpm
SO ./texture/h2.xpm
WE ./texture/h3.xpm
EA ./texture/h4.xpm

F 100,100,100
C 50,50,50


11111111111111111111111111111111111111111111111111
1010111100000011100000010001100100011100000011011 
1011111000010000K000010000111101010110000101011111
100000000S1000111010010111001101000110000110000011
111011100011000000000000001101010010111100001101  
10011111001110111111101110010101110111000111111111
11111111011110000011111100110110111110011100101001
10000000000A00000000000000110110110000100101111111
11010111111011101000000000000000100000011111111011
11010111101011010110110000000010000001000101110101
11001111111000111110101111100000010000000000000001
11100000000000000000000000001110111100011110000011
11111111111111111111111111111111111111111111111111