


NO ./texture/h1.xpm
SO ./texture/h2.xpm
WE ./texture/h3.xpm
EA ./texture/h4.xpm

F 100,100,100
C 50,50,50


11111111111111111111111111111111111111111111111111
1010111100000011100000010001100100011100000011011
10111110000100L0K00001000011110101011000010101111
100000000S1000111010010111001101000110000110000011
1110111000110000000000000011010100101111000011011
100111110011101111111011100101011101110001111111111
111111110111100000111111001101101111100111000101001
10000000000A00L000000000001101101100001001011111111
11010111111011101000000000000000100000011111111011
11010111101011010110110000000010000001000101110101
11001111111000111110101111100000010000000000000001
11100000000000L00000000000001110111100011110000011
11111111111111111111111111111111111111111111111111
