NO ./texture/mossy.xpm
SO ./texture/mossy.xpm
WE ./texture/mossy.xpm
EA ./texture/mossy.xpm
F 220,100,0
C 225,30,0

        1111111111111111111111111
        1000000000110000000000001
        101100000111000000L000001
        10010L0000000000000000001
1111111110110000011100000L0000001
1000000000110000011101111K1111111
11110111111111011100000010001
11110111111111011101010010001
110000001101010111000L0010001
100000000000000011000000A0001
10000000L00000001101010010001
11000001110101011111011110N0111
11110111 1110101 101111010001
11111111 1111111 111111111111
