NO ./texture/redbrick.xpm
SO ./texture/bluestone.xpm
WE ./texture/purplestone.xpm
EA ./texture/greystone.xpm
F 33,84,24
C 28,28,28



1111111111111111111111111
1000000000110000000000001
1011000001110000000000001
1001000000000000000000001
1111111110110000011100001
100000000011000001110111111111111
11110111111111111100000010001
1111011111      1101010010001
1100000011 1111 1100000000001
1000000001 1111 1100000010001
1000000001   11 1101010010001
1100000111111111 111011110N111
11110111 110101 101100010001
11111111 1111111 11111111111




