NO ./path_to_the_north_texture
SO ./path_to_the_south_texture
WE ./path_to_the_west_texture
EA ./path_to_the_east_texture
F 255,0,0
C 0,0,255


1111111111111111111111111
1000000000110000000000001
1011000001110000000000001
1001000000000000000000001
1111111110110000011100001
100000000011000001110111111111111
11110111111111111100000010001
1111011111      1101010010001
1100000011 1111 1100000010001
1000000001 1111 1100000010001
1000000001   11 1101010010001
110000011111111 1111011110N0111
11110111 110101  11111010001
11111111 1111111 11111111111






