


NO ./texture/redbrick.xpm
SO ./texture/bluestone.xpm
WE ./texture/purplestone.xpm
EA ./texture/greystone.xpm

F 186,235,52
C 52,171,235

11111111111111111111111111111111111111111
10000000000000000000000000000000000000001
10000000000000000000000000000000000000001
10000000000000000000000000000000000000001
10000000000000000000000000000000000000001
100000000000000000000000000L0000000000001
10000000000000000000000000000000000000001
10000000000000000000000000000000000000001
1000000000000000000000L000000000000000001
10000000000000000000000000000000000000001
10000000000000000000000000000000000000001
10000000000000000000000000000000000000001
10000000000000000000000000000000000000001
10000000000000000000W00000000000000000001
10000000000000000000000000000000000000001
10000000000000000000000000000000000000001
10000000000000000000000000000000000000001
10000000000000000000000000000000000000001
10000000000000000000000000000000000000001
10000000000000000000000000000000000000001
11111111111111111111111111111111111111111

