


NO ./path_to_the_north_texture
SO ./path_to_the_south_texture
WE ./path_to_the_west_texture
EA ./path_to_the_east_texture

F 186,235,52
C 52,171,235

11111111111111111111111111111111111111111
1E000010001000001000000010000000001010001
11101010101011101011101110111011101011101
10001000100010101000100000101010000000001
10101110111110101111111010101110111111111
10101000100000000010000010100010100010001
10111011111111111010111110101111111010101
10101010001000001010000010000010100000101
10101010101110111011101011111110111111101
10000010101000001000001010100010001000001
10101010111111101110111110101111101011101
10101000000010000010000000000010000000101
10100000001000001010000010000010001010001
11101010111110111011111010111111101010101
10001010100000100000001010100000100010101
10101110101011101111101110101110111010111
10101000101010000010000010001000000010001
10101011101010111011111111111010111010101
10101000001010101000000000001010001000101
10101111111010101011101111101011101111101
10100000100010001010000000101010000000101
11111111111111111111111111111111111111111

