NO ./texture/redbrick.xpm
SO ./texture/bluestone.xpm
WE ./texture/purplestone.xpm
EA ./texture/greystone.xpm

F 186,235,52
C 52,171,235

1111111111111111111111111111111111111111
1111100001111111000000001111110000011111
1111100000001000000000000000000010011111
1111001110000000111111110000001111001111
1111011111000111111111111110001111101111
1111011111000011011111111111001111101111
1111001110010011011111111111100111001111
1111100110011011111111111111100110011111
1111100000100111111111111111110000011111
1111110000100110111111111111110000111111
1111110001111111111111111111111000111111
1111111001111111111111111111111001111111
1111111001111111111111111111111101111111
1111110011110000001111000001111100111111
1111110011111111101111011111111100111111
1111110011111111101111011111111100111111
1111110011111111101111011111111100111111
1111110011111111001111101111110101111111
1111111011111111111111111111111101111111
1111111011111111111111111111011101111111
1111111001111011100000011101100001111111
1111111001111011110000111100111001111111
1111111001110011111000111100110011111111
1111111100000000111001110000000011111111
1111111111000000011111110000001111111111
1111111111100000111111111001101111111111
1111111110111000011001110010110111111111
1111111101110100010010100011011111111111
1111111111101110001111000101111111111111
1111111111111011000E00001110111111111111
1111111111110111100000011110111111111111
1111111111111111111111111111111111111111
