NO ./texture/redbrick.xpm
SO ./texture/bluestone.xpm
WE ./texture/purplestone.xpm
EA ./texture/greystone.xpm
F 186,235,52
C 52,171,235

11111
10001
10101
1E001
11111
