NO ./texture/redbrick.xpm
SO ./texture/bluestone.xpm
WE ./texture/purplestone.xpm
EA ./texture/greystone.xpm
F 186,235,52
C 52,171,235
11111
11011
110011
1100011
11000011
110000011
1100000011
11000000011
110000000011
1100000000011
110000W000001
1111111111111