NO ./texture/redbrick.xpm
SO ./texture/bluestone.xpm
WE ./texture/purplestone.xpm
EA ./texture/greystone.xpm
F 186,235,52
C 52,171,235

11111111111111
100K00000K0001
100110000A0001
100011000K0001
10000111111111
10000011
100000011
1000000011
10000000011
100000000011
10000W000001
111111111111