


NO ./texture/h1.xpm
SO ./texture/h2.xpm
WE ./texture/h3.xpm
EA ./texture/h4.xpm

F 100,100,100
C 50,50,50


11111111111111111111111111111111   
10000000000000001000000110000001   
10100000000000000000000000000001   
11111110111011111110111101111111   
10000000001000111111110000000000111
1111110100111111111111111011111111 
11111101001000000000001110111111111
1000000000101111110000010001       
1010000000100111000000000001       
1010000000100111000010000001       
1010000100111111111111011111       
1010000100101111010110001111       
1000000100100111000110000001       
1010N00000100111000000001111       
1010000000000000000000000001       
1111111111111111111111111111       