


NO ./texture/h1.xpm
SO ./texture/h2.xpm
WE ./texture/h3.xpm
EA ./texture/h4.xpm

F 100,100,100
C 50,50,50


1111111111111111111111111111111111
1000000000000000100000011000000111
1010000000000000000000000000000111
1111111011101111111011110111111111
1000000000100011111111000000000011
1111110100111111111111111011111111
1111110100100000000000111011111111
1000000000101111110000010001
1010000000100111000000000001
1010000000100111000010000001
1010000100111111111111011111
1010000100101111010110001111
1000000100100111000110000001
1010N00000100111000000001111
1010000000K00000000000000001
1111111111111111111111111111